...........XXXX
.XXXXXXXXXXXX+X
.XXXX.......XXX
.XXXX..........
.XXXX..........
...XXXXXXXXXX..
..........XXXXX
XXX.......XXXXX
X XXXXXXXXXXX..
XXXX...........