XXX........
X+XXXX.....
XXXXXXXXX..
.XXXXXXXXX.
.....XX XX.
......XXX..
